QTISensor	KEYWORD1
pusleQTI	KEYWORD2
leftQTI	KEYWORD2
rightQTI	KEYWORD2
setLeftQTIPin	KEYWORD2
setRightQTIPin	KEYWORD2
setRightThreshold	KEYWORD2
setLeftThreshold	KEYWORD2
getRightThreshold	KEYWORD2
getLeftThreshold	KEYWORD2
edgeDetected	KEYWORD2
calibrate	KEYWORD2
QTI_NONE	LITERAL1
QTI_LEFT	LITERAL1
QTI_RIGHT	LITERAL1
QTI_BOTH	LITERAL1
QTI_EDGE_RIGHT	LITERAL1
QTI_EDGE_LEFT	LITERAL1
QTI_EDGE_BOTH	LITERAL1
sethistory	KEYWORD2
